##########
##..M#C###
#@.#....P#
#.P##....#
#.######.#
#........#
##.###..##
##.#...#E#
##C......#
##########