##########
##.###M###
#@.#..#.P#
#.P##....#
#.######.#
#...CCP..#
##.###..##
##.#...#E#
##C......#
##########